..........
...**.....
.a..*...b.
...**.....
..........
