********************
*..................*
*..................*
*...************...*
*..............*...*
*..............*...*
*..............*...*
*..............*...*
*..............*...*
*.a............*...*
*..............*...*
*..............*...*
*..............*...*
*..............*...*
*..............*...*
*..............*...*
*...************...*
*................b.*
*..................*
********************