****************************************************************************************************
*..................................................................................................*
*..*****...........................................................................................*
*......*...........................................................................................*
*..a...*......********************................................................**************...*
*......*.........................*................................................*................*
*..*****.........................*................................................*................*
*................................*................................................*................*
*................................*................................................*................*
*................................*..............***********************************................*
******************************...*..............*..................................................*
*................................*..............*..................................................*
*................................*..............*..................................................*
*................................*..............*..................................................*
*................................*..............*..................................................*
*................................*..............*..................................................*
*................................*..............*..................................................*
*................................*..............*..............********************................*
*................................*..............*..............*...................................*
*................................*..............*..............*...................................*
*................................*..............*..............*********************************...*
*................................*..............*..............*...................................*
*................................*..............*..............*...................................*
*................................*..............*..............*...................................*
*................................*..............*..............*...................................*
*................................*..............*..............*...................................*
*................................*..............*..............*...................................*
*...******************************..............*..............*...................................*
*................................*..............*..............*...................................*
*................................*..............*..............*...................................*
*................................*..............*..............*...................................*
*.............********************..............*..............*...................................*
*...............................................*..............*...................................*
*...............................................*..............*...................................*
*...............................................*..............*...................................*
*...............................................*..............*...................................*
*............************************************..............*...................................*
*............*.................................................*...................................*
*............*.................................................*...*********************************
*............*.................................................*...................................*
*............*.................................................*...................................*
*............*.................................................*...................................*
*............*.................................................*.........................*****.....*
*............*.................................................*.........................*.........*
*............*.................................................********************......*...b.....*
*...**********...........................................................................*.........*
*........................................................................................*****.....*
*..................................................................................................*
*..................................................................................................*
****************************************************************************************************