*******************************************************************************************************************************************************************************************************************************************
*.........a*..................................................................................................................................................................................................................*b..........*
*..........*..............................................................................................*...................................................................................................................*...........*
*..........*..............................................................................................*...................................................................................................................*...........*
*..........*..............................................................................................*...................................................................................................................*...........*
*..........*..............................................................................................*...................................................................................................................*...........*
*..........*..............................................................................................*...................................................................................................................*...........*
*..........*..............................................................................................*...................................................................................................................*...........*
*..........*..............................................................................................*...................................................................................................................*...........*
*..........*..............................................................................................*...................................................................................................................*...........*
*..........*..............................................................................................*...................................................................................................................*...........*
*..........*..............................................................................................*...................................................................................................................*...........*
*..........*..............................................................................................*...................................................................................................................*...........*
*..........*..............................................................................................*...................................................................................................................*...........*
*..........*..............................................................................................*...................................................................................................................*...........*
*..........*..............................................................................................*...................................................................................................................*...........*
*..........*..............................................................................................*...................................................................................................................*...........*
*..........*..............................................................................................*...................................................................................................................*...........*
*..........*..............................................................................................*...................................................................................................................*...........*
*..........*..............................................................................................*...................................................................................................................*...........*
*..........*..............................................................................................*...................................................................................................................*...........*
*..........*..............................................................................................*...................................................................................................................*...........*
*..........*..............................................................................................*...................................................................................................................*...........*
*..........*..............................................................................................*...................................................................................................................*...........*
*..........*..............................................................................................*...................................................................................................................*...........*
*..........*..............................................................................................*...................................................................................................................*...........*
*..........*..............................................................................................*...................................................................................................................*...........*
*..........*..............................................................................................*...................................................................................................................*...........*
*..........*..............................................................................................*...................................................................................................................*...........*
*..........*..............................................................................................*...................................................................................................................*...........*
*..........*..............................................................................................*...................................................................................................................*...........*
*..........*..............................................................................................*...................................................................................................................*...........*
*..........*..............................................................................................*...................................................................................................................*...........*
*..........*..............................................................................................*...................................................................................................................*...........*
*..........*..............................................................................................*...................................................................................................................*...........*
*..........*..............................................................................................*...................................................................................................................*...........*
*..........*..............................................................................................*...................................................................................................................*...........*
*..........*..............................................................................................*...................................................................................................................*...........*
*..........*..............................................................................................*...................................................................................................................*...........*
*..........*..............................................................................................*...................................................................................................................*...........*
*..........*..............................................................................................*...................................................................................................................*...........*
*..........*..............................................................................................*...................................................................................................................*...........*
*..........*..............................................................................................*...................................................................................................................*...........*
*..........*..............................................................................................*...................................................................................................................*...........*
*..........*..............................................................................................*...................................................................................................................*...........*
*..........*..............................................................................................*...................................................................................................................*...........*
*..........*..............................................................................................*...................................................................................................................*...........*
*..........*..............................................................................................*...................................................................................................................*...........*
*..........*..............................................................................................*...................................................................................................................*...........*
*..........*..............................................................................................*...................................................................................................................*...........*
*..........*..............................................................................................*...................................................................................................................*...........*
*.........................................................................................................*...............................................................................................................................*
*******************************************************************************************************************************************************************************************************************************************